############################################
#                                          #
#                                          #
#                                          #
#                                          #
#                                          #
#                                          #
#                                          #
#                                          #
#                                          #
#                                          #
#                                          #
#                                          #
#                                          #
#                                          #
#                                          #
#                                          #
#                                          #
#                                          #
#                                          #
#                                          #
#                                          #
#                                          #
#                                          #
#                                          #
#                                          #
#                                          #
#                                          #
#                                          #
#      ###################                 #
#                                          #
#                                          #
#                                          #
#                                          #
#                                          #
#                                          #
#                                          #
#                                          #
#                                          #
#                                          #
#                                          #
#                                          #
#                                          #
#                                          #
#                                          #
#                                          #
#                                          #
#                                          #
#                                          #
#                                          #
#                                          #
#                                          #
#                                          #
#                                          #
#                                          #
#                                          #
############################################
